3,3,3,3,3,3,3,3,3,3,3,3,0,3,3,3,3,3,3,3,3,
3,3,3,3,3,3,3,0,3,3,3,3,3,3,3,3,3,3,3,3,3,
3,3,0,3,3,3,3,3,3,3,3,3,3,3,3,3,3,3,0,3,3,
3,3,3,3,3,3,3,3,3,3,3,3,3,0,3,3,3,3,3,3,3,
3,3,3,3,3,3,3,3,0,3,3,3,3,3,3,3,3,3,3,3,3,
3,3,3,0,3,3,3,3,3,3,3,3,3,3,3,3,3,3,3,0,3,
3,3,3,3,3,3,3,3,3,3,3,3,3,3,0,3,3,3,3,3,3,
3,3,3,3,3,3,3,3,3,0,3,3,3,3,3,3,3,3,3,3,3,
3,3,3,3,0,3,3,3,3,3,3,3,3,3,3,3,3,3,3,3,0,
3,3,3,3,3,3,3,3,3,3,3,3,3,3,3,0,3,3,3,3,3,
3,3,3,3,3,3,3,3,3,3,0,3,3,3,3,3,3,3,3,3,3,
3,3,3,3,3,0,3,3,3,3,3,3,3,3,3,3,3,3,3,3,3,
0,3,3,3,3,3,3,3,3,3,3,3,3,3,3,3,0,3,3,3,3,
3,3,3,3,3,3,3,3,3,3,3,0,3,3,3,3,3,3,3,3,3,
3,3,3,3,3,3,0,3,3,3,3,3,3,3,3,3,3,3,3,3,3,
3,0,3,3,3,3,3,3,3,3,3,3,3,3,3,3,3,0,3,3,3,
3,3,3,3,3,3,3,3,3,3,3,3,0,3,3,3,3,3,3,0,3,
3,3,0,3,3,3,0,0,3,3,0,0,0,0,0,0,0,0,0,0,0,
0,0,0,0,0,0,0,10,0,0,0,10,0,0,0,10,0,0,0,10,0,
0,0,0,0,0,0,0,0,0,0,0,0,0,0,0,0,0,0,0,0,0,
0,0,0,0,0,0,0,0,0,0,0,0,9,0,0,9,0,0,0,9,0,
0,0,9,0,0,0,9,0,0,0,0,0,0,0,0,0,0,0,0,0,0,
0,0,10,0,0,9,0,0,0,9,0,0,0,9,0,0,0,9,0,0,0,
0,0,0,0,0,0,0,0,0,0,0,0,0,0,0,0,0,0,0,0,0,
0,0,0,0,0,0,0,0,0,11,0,0,0,11,0,0,0,11,0,0,0,
11,0,0,0,0,0,0,0,0,0,0,0,0,0,0,0,0,0,0,0,0,
0,9,0,0,0,9,0,0,0,9,0,0,0,9,0,0,0,0,0,0,0,
0,0,0,0,0,0,0,0,0,0,0,0,0,0,0,0,0,0,0,0,0,
0,0,0,0,0,12,0,9,0,12,0,9,0,12,0,9,0,12,0,9,10,
0,0,0,0,0,0,0,0,0,0,0,0,0,0,0,0,0,0,0,0,0,
0,0,0,0,0,0,0,0,0,0,0,0,12,0,0,0,12,0,0,0,12,
0,0,0,12,0,0,0,0,0,0,0,0,0,0,0,0,0,0,0,0,0,
0,0,0,0,0,0,0,0,0,0,0,0,0,0,0,0,9,0,0,0,0,
0,0,0,0,0,0,0,0,0,0,0,0,0,0,0,0,0,0,0,0,0,
0,0,0,0,0,0,7,7,7,7,7,7,7,7,7,7,7,7,0,7,7,
7,7,0,8,8,7,0,8,8,7,0,8,8,0,0,8,8,8,8,0,7,
8,8,0,7,8,8,0,7,15,8,0,7,7,7,7,7,8,7,7,7,8,
7,7,7,15,7,7,7,8,8,8,8,8,8,8,8,8,8,8,8,15,8,
8,8,7,7,7,7,8,7,7,7,8,7,7,7,15,7,7,7,7,7,7,
8,8,7,7,8,8,7,7,8,15,7,7,8,8,8,8,8,8,8,8,8,
8,8,8,8,15,8,8,8,7,7,7,7,8,7,7,7,8,7,7,7,15,
7,7,7,8,8,8,8,8,8,8,8,8,8,8,8,15,8,8,8,8,8,
7,7,8,8,7,7,8,8,7,7,15,8,7,7,7,7,7,7,8,7,7,
7,8,7,7,7,15,7,7,7,8,8,8,8,8,8,8,8,8,8,8,8,
15,8,8,8,7,7,7,7,8,7,7,7,8,7,7,7,15,7,7,7,7,
7,8,8,8,7,8,8,8,7,8,8,15,7,8,8,8,8,8,8,8,8,
8,8,8,8,8,8,15,8,8,8,7,7,7,7,8,7,7,7,8,7,7,
7,15,7,7,7,8,8,8,8,8,8,8,8,8,8,8,8,15,8,8,8,
8,7,7,7,7,7,7,7,7,7,7,7,0,7,7,7,7,7,7,7,8,
7,7,7,8,7,7,7,15,7,7,7,8,8,8,8,8,8,8,8,8,8,
8,8,15,8,8,8,7,7,7,7,7,7,7,7,7,7,7,7,0,7,7,
7,7,0,0,0,0,0,0,0,0,0,0,0,0,0,0,0,0,0,0,0,
0,0,0,0,0,0,0,0,0,0,0,0,0,0,0,0,0,0,0,0,0,
0,0,0,0,0,0,0,0,0,0,0,0,0,0,0,0,0,0,0,0,0,
0,0,0,0,0,0,0,0,0,0,0,0,0,0,0,0,0,0,0,0,0,
0,0,0,0,0,0,0,0,0,0,0,0,0,0,0,0,0,0,0,0,0,
0,0,0,0,0,0,0,0,0,0,0,0,0,0,0,0,0,0,0,0,0,
0,0,0,0,0,0,0,0,0,0,0,0,0,0,0,0,0,0,0,0,0,
0,0,0,0,0,0,0,0,0,0,0,0,0,0,0,0,0,0,0,0,0,
0,0,0,0,0,0,0,0,0,0,0,0,0,0,0,0,0,0,0,0,0,
0,0,0,0,0,0,0,0,0,0,0,0,0,0,0,0,0,0,0,0,0,
0,0,0,0,0,0,0,0,0,0,0,0,0,0,0,0,0,0,0,0,0,
0,0,0,0,0,0,0,0,0,0,0,0,0,0,0,0,0,0,0,0,0,
0,0,0,0,0,0,0,0,0,0,0,0,0,0,0,0,0,0,0,0,0,
0,0,0,0,0,0,0,0,0,0,0,0,0,0,0,0,0,0,0,0,0,
0,0,0,0,0,0,0,0,0,0,0,0,0,0,0,0,0,0,0,0,0,
0,0,0,0,0,0,0,0,0,0,0,0,0,0,0,0,0,0,0,0,0,
0,0,0,0,0,0,0,0,0,0,0,0,0,0,0,0,0,0,0,0,0,
0,0,0,0,0,0,0,0,0,0,0,0,